username=felhasználónév
password=Jelszó
register=Regisztráció
signIn=Bejelentkezés
logout=Kijelentkezés
commands=Parancsok
help=Segítség
languages=Nyelvek
filter=szűrő
errorParsingPerson=Hibás mezőértékek – üresek, rossz típusok vagy határokon kívül!
added=Személy sikeresen hozzáadva!
notMinPerson=A személy nem kisebb a minimális személynél!
cleared=Gyűjtemény törölve!
forbiddenCommand=Ez a parancs nem használható szkriptben
noRights=Nincs joga a fájl olvasásához/írásához
noArgument=Nem található argumentum ehhez a parancshoz!
lastSave=Utolsó mentés dátuma
lastInit=Az utolsó inicializálás dátuma
emptyCollection=A gyűjtemény üres!
removed=Személy(ek) eltávolítása sikeres volt!
notNumber=Az érvnek számnak kell lennie!
personNotFound=A személy nem található!
updated=Személy sikeresen frissítve!
notUniqueLogin=Már létezik ilyen felhasználónévvel rendelkező felhasználó
wrongLoginOrPassword=Rossz felhasználónév vagy jelszó
denied=Hozzáférés megtagadva
add=új elem hozzáadása a gyűjteményhez
addIfMin=adjunk hozzá új elemet, ha annak értéke kisebb, mint a legkisebbé
clear=törölje a gyűjteményt
executeScript=parancsfájl végrehajtása a megadott fájlból
filterStarts=olyan elemeket jelenít meg, amelyek nevének mező értéke a megadott részkarakterlánccal kezdődik
groupCounting=csoportosítsa a gyűjtemény elemeit a mezőazonosító értéke szerint
helpC=súgó megjelenítése az elérhető parancsokról
info=információk megjelenítése a gyűjteményről
printUnique=a gyűjtemény összes elemének helymezőjének egyedi értékeit adja ki
remove=elem eltávolítása a gyűjteményből azonosító alapján
removeGreater=távolítsa el a gyűjteményből az összes megadottnál nagyobb elemet
removeLower=távolítson el minden, az adottnál kisebb elemet a gyűjteményből
show=megjeleníti a gyűjtemény összes elemét
update=gyűjteményelem értékének frissítése azonosítóval
greeting=Születtem!