username=корисничко име
password=Лозинка
register=регистровати
signIn=Пријавите се
logout=одјавити се
commands=Команде
help=Помоћ
languages=Језици
filter=филтер
errorParsingPerson=Погрешне вредности поља - празне, лоше врсте или су ван граница!
added=Особа је успешно додата!
notMinPerson=Особа није мање од минималне особе!
cleared=Колекција је обрисана!
forbiddenCommand=Ова команда није дозвољена за коришћење у скрипти
noRights=Нема права за читање/писање датотеке
noArgument=Није пронађен ниједан аргумент за ову команду!
lastSave=Датум последњег чувања
lastInit=Последњи датум иницијализације
emptyCollection=Колекција је празна!
removed=Особа(е) је успешно уклоњена!
notNumber=Аргумент мора бити број!
personNotFound=Особа није пронађена!
updated=Особа је успешно ажурирана!
notUniqueLogin=Корисник са таквим корисничким именом већ постоји
wrongLoginOrPassword=Погрешно корисничко име или лозинка
denied=Приступ одбијен
add=додајте нови елемент у колекцију
addIfMin=додати нови елемент ако је његова вредност мања од најмањег
clear=очистите колекцију
executeScript=изврши скрипту из одређене датотеке
filterStarts=приказује елементе чија вредност поља имена почиње датим поднизом
groupCounting=груписати ставке колекције према вредности ИД поља
helpC=прикажи помоћ за доступне команде
info=приказати информације о колекцији
printUnique=излази јединствене вредности поља локације свих елемената у колекцији
remove=уклоните предмет из колекције по ИД-у
removeGreater=уклонити из колекције све елементе веће од датих
removeLower=уклонити из колекције све елементе мање од датог
show=приказати све елементе колекције
update=ажурирање вредности елемента колекције према ИД-у
greeting=Рођен сам!