username=имя пользователя
password=пароль
register=регистрация
signIn=вход
logout=выход
commands=Команды
help=Помощь
languages=Языки
filter=фильтр
errorParsingPerson=Неправильные значения полей - пустые, неверные типы или не соответствуют требованиям!
added=Человек успешно добавлен!
notMinPerson=Человек не меньше минимального человека!
cleared=Коллекция очищена!
forbiddenCommand=Эту команду нельзя использовать в скрипте
noRights=Нет прав на чтение/запись файла
noArgument=Для этой команды не найден аргумент!
lastSave=Дата последнего сохранения
lastInit=Дата последней инициализации
emptyCollection=Коллекция пуста!
removed=Человек(люди) удален(ы) успешно!
notNumber=Аргумент должен быть числом!
personNotFound=Человек не найден!
updated=Пользователь успешно обновлен!
notUniqueLogin=Пользователь с таким логином уже существует
wrongLoginOrPassword=Неверное имя пользователя или пароль
denied=В доступе отказано
add=добавить новый элемент в коллекцию
addIfMin=добавить новый элемент, если его значение меньше, чем у наименьшего
clear=очистить коллекцию
executeScript=выполнить скрипт из указанного файла
filterStarts=отображает элементы, значение поля имени которых начинается с заданной подстроки
groupCounting=сгруппировать элементы коллекции по значению ID
helpC=показать справку по доступным командам
info=отображать информацию о коллекции
printUnique=выводит уникальные значения поля местоположения всех элементов в коллекции
remove=удалить предмет из коллекции по ID
removeGreater=удалить из коллекции все элементы больше заданного
removeLower=удалить из коллекции все элементы меньше заданного
show=отображать все элементы коллекции
update=обновить значение элемента коллекции по ID
greeting=Я родился!